+--+--+--+--+--+--+--+--+--+--+--+--+--+--+--+--+--+--+--+--+
         |        |                 |        |     |        |
+--+--+  +--+  +  +--+  +--+--+  +--+  +--+  +--+  +  +--+  +
|     |  |     |     |  |     |     |     |     |     |     |
+  +  +  +  +--+--+  +  +  +  +--+  +--+  +--+  +--+--+  +--+
|  |     |  |        |  |  |        |  |  |           |  |  |
+  +--+--+  +  +--+--+  +  +--+--+--+  +  +--+--+--+  +  +  +
|        |  |           |        |  |  |     |     |        |
+--+--+  +  +--+  +--+--+--+--+  +  +  +--+  +--+  +--+--+--+
|     |     |     |           |  |     |        |        |  |
+  +--+--+  +  +--+  +  +--+  +  +  +--+--+--+  +--+--+  +  +
|     |     |  |     |     |  |     |           |     |     |
+--+  +  +--+  +  +--+--+  +--+--+--+--+--+  +--+  +  +--+  +
|     |  |     |  |     |     |     |     |  |     |     |  |
+  +--+  +  +--+  +  +  +--+  +  +--+  +  +  +  +--+--+  +  +
|  |     |  |     |  |  |     |        |  |  |     |     |  |
+  +--+--+  +  +--+  +--+  +--+--+--+--+  +  +--+  +  +--+  +
|  |        |        |     |           |     |     |  |     |
+  +  +--+--+--+--+--+  +--+  +--+--+  +  +--+--+--+  +  +  +
|     |        |     |  |        |  |  |     |     |  |  |  |
+  +--+  +  +--+  +  +  +  +  +  +  +  +--+  +  +  +  +--+  +
|        |     |  |     |  |  |     |     |     |  |  |     |
+--+--+--+--+  +  +--+--+  +  +--+--+--+  +--+--+  +  +  +--+
|              |  |        |  |     |     |  |     |  |  |  |
+  +--+--+--+--+  +  +--+--+--+  +  +--+  +  +  +--+  +  +  +
|     |  |     |  |  |     |     |        |  |  |        |  |
+--+  +  +  +  +  +  +--+  +  +--+--+--+--+  +  +  +  +--+  +
|     |     |  |        |     |  |     |     |     |     |  |
+  +--+--+--+  +--+--+  +--+--+  +  +  +  +  +--+--+  +  +  +
|     |              |  |        |  |     |        |  |     |
+--+  +--+--+--+--+  +  +--+--+  +  +--+--+--+--+  +  +--+--+
|     |              |     |     |           |  |  |  |     |
+  +--+  +--+--+--+--+--+  +  +--+--+--+--+  +  +  +  +  +--+
|  |                    |  |  |           |  |  |     |     |
+  +  +  +--+--+  +  +--+  +  +--+--+--+  +  +  +  +  +--+  +
|     |        |  |     |  |     |        |     |  |  |     |
+--+--+--+--+  +--+--+  +  +--+  +  +  +  +  +--+  +  +  +--+
|  |        |  |        |        |  |  |  |     |  |  |     |
+  +  +--+  +  +  +--+--+  +--+--+  +  +--+  +  +  +--+--+  +
|        |     |                    |        |  |            
+--+--+--+--+--+--+--+--+--+--+--+--+--+--+--+--+--+--+--+--+

