+--+--+--+--+--+--+--+--+--+--+--+--+--+--+--+--+--+--+--+--+--+--+--+--+--+--+--+--+--+--+--+--+--+--+--+--+--+--+--+--+
   |        |        |        |        |     |  |              |     |        |  |     |           |     |        |     |
+  +--+--+  +  +--+  +  +--+  +  +--+--+  +  +  +  +--+--+--+  +  +  +--+--+  +  +  +  +--+--+--+  +  +--+  +--+  +--+  +
|        |  |  |     |     |  |     |     |  |  |        |     |  |  |     |  |     |           |  |           |     |  |
+--+--+  +  +  +--+--+--+  +  +--+  +  +--+  +  +--+--+  +--+  +  +  +  +  +  +  +--+--+--+--+  +  +--+--+--+--+--+  +  +
|     |  |  |        |  |  |  |     |     |  |        |  |     |  |  |  |     |  |           |  |  |           |        |
+  +  +  +  +  +--+  +  +  +  +  +  +--+  +  +--+  +--+  +  +--+  +  +  +--+--+  +  +--+--+  +  +  +  +--+  +  +--+--+  +
|  |     |  |  |        |  |  |  |        |     |        |     |  |  |     |     |     |        |  |     |  |        |  |
+  +--+--+  +--+  +  +  +--+  +  +--+--+--+--+  +--+--+  +  +  +  +  +--+  +  +--+--+  +--+  +  +  +  +  +  +--+--+  +  +
|     |     |     |  |     |  |  |              |     |  |  |  |  |     |  |  |        |     |  |     |  |  |     |  |  |
+  +--+  +--+  +--+--+  +  +  +  +--+--+--+--+--+  +  +--+  +--+  +  +  +  +  +--+--+--+  +--+--+--+--+  +  +--+  +  +  +
|           |  |        |     |     |     |  |     |        |     |  |     |     |     |        |        |        |     |
+--+--+--+  +  +  +--+--+--+--+--+  +  +  +  +  +--+  +  +--+  +--+--+--+--+--+  +  +  +--+--+  +  +--+--+--+--+  +--+--+
|           |  |        |     |     |  |  |     |     |     |     |           |     |     |     |     |        |        |
+  +--+--+--+  +--+--+  +  +  +  +--+  +  +  +--+  +--+--+--+--+  +  +--+--+  +--+--+--+  +--+--+--+  +  +--+  +--+--+  +
|     |        |        |  |  |     |  |  |     |  |           |  |  |     |  |        |  |     |  |  |     |     |     |
+--+  +  +--+--+  +  +--+  +  +--+  +  +  +--+  +  +  +--+--+  +  +  +  +  +  +  +--+  +  +  +  +  +  +--+  +--+  +  +--+
|     |     |  |  |        |           |        |     |        |  |  |  |  |  |  |     |     |  |  |     |  |  |  |     |
+  +--+--+  +  +  +--+  +  +  +--+--+--+--+  +--+--+--+  +--+--+  +--+  +  +  +  +  +--+  +--+  +  +--+  +  +  +  +--+  +
|  |        |     |  |  |  |        |     |  |     |     |     |        |  |     |  |     |     |     |  |  |  |  |     |
+  +  +--+--+--+--+  +  +  +--+--+  +  +  +--+  +  +  +--+  +  +--+--+--+  +--+--+  +  +--+  +--+  +  +  +  +  +  +  +--+
|  |     |           |  |  |        |  |     |  |     |     |              |     |  |  |  |  |     |     |  |     |  |  |
+  +--+  +  +--+--+  +  +--+  +--+--+  +--+  +--+--+--+--+  +--+--+--+  +--+--+  +  +  +  +  +--+--+--+--+  +--+--+  +  +
|     |  |  |     |     |     |     |  |     |     |        |        |     |     |  |  |  |  |           |        |     |
+--+  +  +  +  +--+--+--+  +--+  +  +  +--+--+  +  +  +--+--+  +--+  +--+  +  +--+  +  +  +  +  +--+--+  +  +--+  +  +--+
|     |  |  |           |        |  |        |  |  |  |     |     |        |  |        |        |        |  |     |  |  |
+  +--+  +  +--+--+  +--+--+--+--+  +--+  +  +--+  +  +  +  +--+  +--+--+--+  +  +--+--+--+  +--+  +--+--+  +  +--+  +  +
|        |     |        |        |     |  |     |  |     |     |     |     |  |           |  |  |  |     |  |     |     |
+--+--+--+--+  +--+--+  +  +  +  +  +  +  +--+  +  +--+--+--+--+--+  +  +--+  +--+--+--+  +  +  +  +  +  +  +--+  +  +--+
|        |  |  |        |  |  |     |  |  |     |  |           |  |        |     |        |     |     |  |     |        |
+  +--+  +  +  +  +--+--+  +--+--+--+--+  +  +--+  +  +--+--+  +  +--+--+  +  +--+  +--+--+  +--+--+--+  +--+  +--+--+  +
|     |     |  |     |  |        |     |  |  |     |  |        |     |     |        |        |     |  |     |  |     |  |
+  +  +--+  +  +--+  +  +--+  +  +--+  +  +  +  +--+  +  +--+--+  +  +  +--+--+--+  +--+--+--+  +  +  +--+  +  +--+  +  +
|  |     |  |  |     |  |  |  |  |     |  |  |  |     |           |  |     |     |     |     |  |     |     |  |     |  |
+--+--+  +--+  +  +--+  +  +  +  +  +--+  +  +  +  +--+--+--+--+--+  +  +--+  +  +--+  +  +  +  +  +--+  +--+  +  +--+  +
|                       |     |     |     |  |  |  |        |     |     |     |        |  |  |  |  |     |     |  |     |
+  +--+--+--+  +--+--+--+--+--+--+--+  +--+  +  +  +  +--+  +  +  +--+--+  +  +--+--+--+  +  +  +  +  +--+  +--+  +  +--+
|  |           |           |        |     |  |  |  |  |     |  |        |  |        |     |  |  |  |  |  |  |     |     |
+  +  +--+--+--+  +--+--+  +  +--+  +--+  +  +  +  +--+  +--+  +  +--+  +  +--+--+  +  +--+  +  +  +  +  +  +  +--+--+  +
|  |        |     |        |     |     |  |     |  |     |     |     |  |     |     |  |     |  |  |        |  |     |  |
+  +--+--+  +  +--+  +--+--+  +  +--+--+  +--+  +  +  +--+  +--+  +  +  +--+  +  +--+  +  +--+  +  +--+  +--+  +  +  +  +
|        |  |     |  |     |  |     |     |     |  |  |     |  |  |  |     |  |  |     |  |     |  |  |        |  |     |
+--+--+  +  +--+  +  +  +  +  +--+  +  +--+--+--+  +  +  +--+  +  +  +--+--+  +  +  +--+  +  +--+  +  +--+--+--+  +  +--+
|        |        |     |     |     |  |        |  |  |  |     |  |        |  |     |     |  |  |     |        |  |     |
+  +  +--+--+--+--+--+--+--+  +  +--+  +  +--+  +  +  +  +--+  +--+--+  +  +  +--+--+  +--+  +  +--+--+  +--+--+  +--+  +
|  |           |        |     |     |  |     |     |  |     |  |     |  |     |        |           |  |        |  |     |
+--+--+--+--+--+  +--+  +--+--+  +  +  +--+  +--+--+  +--+  +  +  +  +--+--+--+  +--+--+--+  +--+  +  +  +--+  +  +--+--+
|     |           |  |     |     |  |     |        |              |     |        |  |     |  |        |     |  |        |
+  +  +  +--+--+--+  +--+  +--+--+  +--+  +--+--+  +--+--+  +--+--+--+  +  +--+--+  +  +  +  +--+--+--+--+--+  +--+--+  +
|  |  |              |  |              |  |     |        |  |           |           |  |     |        |           |     |
+  +--+--+--+  +--+--+  +  +--+--+  +--+  +  +  +  +--+  +  +  +--+--+--+--+--+--+  +  +--+--+  +  +--+  +--+  +  +  +--+
|  |        |           |  |     |        |  |  |     |  |  |        |     |        |  |        |     |  |     |     |  |
+  +  +  +--+  +--+--+--+--+  +  +--+--+--+--+  +  +--+  +  +--+--+--+  +  +  +--+--+  +  +--+--+--+  +  +  +--+--+--+  +
|     |     |     |           |  |        |     |     |  |              |  |           |  |        |     |  |     |     |
+--+--+--+  +  +  +  +--+--+  +  +--+--+  +  +--+--+  +  +--+--+--+--+--+  +--+--+--+--+  +--+--+  +--+--+  +  +--+  +--+
|  |        |  |  |  |     |  |  |        |  |        |  |              |  |           |           |        |     |  |  |
+  +  +--+--+  +  +  +--+  +--+  +  +--+--+  +--+--+  +  +  +--+--+  +--+  +  +--+--+  +--+--+--+--+  +  +--+  +  +  +  +
|     |     |  |     |     |     |  |     |  |     |  |  |  |        |              |  |     |  |     |        |  |  |  |
+  +--+--+  +  +--+--+  +--+  +--+  +  +  +  +  +  +  +  +  +  +--+--+  +--+--+--+  +  +  +  +  +  +--+--+--+--+  +  +  +
|  |           |        |     |     |  |     |  |  |  |  |  |  |        |        |  |  |  |     |        |     |     |  |
+  +  +--+  +  +  +--+--+  +--+--+  +  +--+--+  +  +  +  +  +  +--+--+--+  +--+  +--+  +  +--+--+--+--+  +  +  +--+  +  +
|     |     |  |           |        |     |     |     |     |  |        |     |        |  |              |  |  |     |  |
+--+--+  +  +--+--+--+--+--+  +--+--+--+  +  +  +--+--+--+  +  +  +--+  +--+  +--+--+--+  +  +--+--+  +--+  +  +  +--+  +
|     |  |  |     |     |     |           |  |     |        |  |  |     |     |        |     |     |  |     |  |        |
+--+  +  +--+  +  +  +  +  +--+  +--+--+--+  +--+--+  +--+--+  +  +  +--+  +--+  +--+  +--+--+--+  +  +  +  +  +--+--+--+
|        |     |     |     |     |           |     |  |     |  |  |           |     |           |  |     |  |           |
+  +--+--+  +--+--+--+  +--+  +--+  +--+  +--+  +  +  +  +  +  +  +--+--+--+  +--+  +--+--+--+  +  +--+--+--+--+  +--+  +
|  |     |  |        |     |           |        |  |     |  |     |        |  |        |     |  |           |     |     |
+  +  +  +  +--+--+  +--+  +--+--+  +--+  +--+--+--+--+--+  +--+--+--+  +  +  +--+--+  +  +  +  +--+--+--+  +  +--+--+  +
|  |  |  |  |     |     |  |        |           |     |     |     |     |  |     |     |  |  |  |        |     |     |  |
+  +  +  +  +  +  +--+  +  +--+  +--+  +--+--+  +  +--+  +  +  +  +  +--+--+--+  +--+--+  +  +  +  +--+  +--+--+  +  +--+
|  |  |  |  |  |     |  |     |  |     |        |        |  |  |  |              |     |  |     |     |  |     |  |     |
+  +  +  +  +  +--+  +  +--+  +  +  +--+  +  +--+--+--+--+  +  +  +--+--+--+--+--+  +  +  +--+--+--+  +  +--+  +  +--+  +
|     |  |  |     |        |  |  |  |     |  |     |     |     |                 |  |  |           |  |     |     |  |  |
+  +--+  +  +--+  +--+--+--+  +--+  +  +--+  +  +  +  +  +--+--+--+  +  +  +--+  +  +  +--+--+--+  +--+--+  +  +  +  +  +
|     |     |              |        |     |     |  |  |              |  |     |     |                       |  |  |  |  |
+--+  +--+--+  +  +--+--+  +--+--+--+--+  +--+--+  +  +--+--+--+--+--+  +--+  +--+--+  +--+--+--+  +--+--+  +  +  +  +  +
|     |        |  |     |     |     |     |        |  |  |              |        |  |  |        |        |     |  |     |
+  +--+--+  +--+  +  +--+--+  +  +--+  +--+  +--+--+  +  +  +--+--+--+--+  +--+  +  +  +  +--+  +  +--+  +--+  +  +--+--+
|           |     |           |        |     |        |     |              |     |     |     |     |     |     |         
+--+--+--+--+--+--+--+--+--+--+--+--+--+--+--+--+--+--+--+--+--+--+--+--+--+--+--+--+--+--+--+--+--+--+--+--+--+--+--+--+

