+--+--+--+--+--+
   |           |
+  +  +--+--+  +
|     |  |     |
+--+--+  +  +--+
|     |     |  |
+  +  +--+  +  +
|  |        |  |
+  +--+--+--+  +
|               
+--+--+--+--+--+

